P E E E E E E E E E E E E E E E E E E E
W W W W W W W W W W W W W W W W W W W E
O O O O O O O O O O O O O O O O O O O E
O W W W W W W W W W W W W W W W W W O E
O W E E E E E E E E E E E E E E E W O E
O W E W W W W W W W W W W W W W E W O E
O W E W E E E E E E E E E E E W E W O E
O W E W E W W W W W W W W W E W E W O E
O W E W E W E E E E E E E W E W E W O E
O W E W E W E W W W W W E W E W E W O E
O W E W E W E W E E E W E W E W E W O E
O W E W E W E W E W E W E W E W E W O E
O W E W E W E W E W E W E W E W E W O E
O W E W E W E W E W E W E W E W E W O E
O W E W E W E W E W E W E W E W E W O E
O W E W E W E W E W E W E W E W E W O E
O W E W E W E E E E E E E W E W E W O E
O W E W W W W W W W W W W W E W E W O E
O O O O O O O O O O O O O O O O O O O E
E E E E E E E E E E E E E E E E E E E G