W W W W W W W W W W W W W W W W W W W W
W E E E E E E E E E E E E E E E E E E W
W E W W W W W W W E E W W W W W W W E W
W E W E E E E E W E E W E E E E E W E W
W E W E W W W E W E E W E W W W E W E W
W E W E W E W E W E E W E W E W E W E W
W E W E W E W E W E E W E W E W E W E W
W E W E W W W E W E E W E W W W E W E W
W E W E E E E E W E E W E E E E E W E W
W E W W W W W W W E E W W W W W W W E W
W P E E E E E E E W W E E E E E E E G W
W E W W W W W W W E E W W W W W W W E W
W E W E E E E E W E E W E E E E E W E W
W E W E W W W E W E E W E W W W E W E W
W E W E W E W E W E E W E W E W E W E W
W E W E W E W E W E E W E W E W E W E W
W E W E W W W E W E E W E W W W E W E W
W E W E E E E E W E E W E E E E E W E W
W E W W W W W W W E E W W W W W W W E W
W W W W W W W W W W W W W W W W W W W W
