P E E E W E E E E E W E E E E E O O O E
W W W E W E W W W E W E W W W E W W O E
E E E E W E E E W E E E W E E E W E O E
E W W W W W W E W W W E W E W W W E O E
E W T E E E W E E E W E W E W E E E O E
E W E W W E W W W E W E W E W E W W O E
E E E W E E E E W E E E W E E E W E O E
W W E W E W W E W W W E W W W E W E O E
E E E W E W E E E E W E E E W E E E O E
E W W W E W E W W E W W W E W W W E O E
E E E E E W E E W E E E W E E E W E O E
O O O O E W W E W W W E W E W E W E O E
E W W O E E E E E E W E E E W E E E O E
E W E O W W W W W E W W W E W W W E O E
E W E O E E E E W E E E W E E E W E O E
E W E O E W W E W W W E W E W E W E O E
E E E O E E W E E E E E W E W E E E O E
W W E O W E W W W W W E W E W W W E O E
E E E O E E E E E E E E E E E E E E O G
E W W W W W W W W W W W W W W W W W W W
